11111111111111111
10000000000000001
10000000000000001
1P001000001100001
1C1010000C0011E11
10000000000000001
10000000000000001
11111111111111111